"aa" = (/turf/space,/area/space)
"ab" = (/turf/simulated/mineral,/area/space)
"ac" = (/turf/unsimulated/wall,/area/innie_base)
"ad" = (/obj/structure/table/steel,/obj/item/device/flashlight/lamp,/turf/unsimulated/floor{icon_state = "lino"},/area/innie_base)
"ae" = (/obj/structure/table/steel,/obj/machinery/light{tag = "icon-tube1 (NORTH)"; icon_state = "tube1"; dir = 1},/turf/unsimulated/floor{icon_state = "lino"},/area/innie_base)
"af" = (/obj/structure/table/steel,/turf/unsimulated/floor{icon_state = "lino"},/area/innie_base)
"ag" = (/obj/machinery/light{dir = 1},/turf/unsimulated/floor{dir = 2; icon_state = "dark"},/area/innie_base)
"ah" = (/turf/unsimulated/floor{dir = 2; icon_state = "dark"},/area/innie_base)
"ai" = (/obj/structure/grille,/obj/structure/window/reinforced{dir = 8},/obj/structure/window/reinforced{dir = 1},/turf/space,/area/innie_base)
"aj" = (/turf/unsimulated/wall/fakeglass{icon_state = "fakewindows"; dir = 4},/area/innie_base)
"ak" = (/obj/structure/bed,/obj/item/weapon/bedsheet/brown,/turf/unsimulated/floor{icon_state = "lino"},/area/innie_base)
"al" = (/obj/effect/landmark{name = "Insurrectionist-Spawn"},/turf/unsimulated/floor{icon_state = "lino"},/area/innie_base)
"am" = (/turf/unsimulated/floor{icon_state = "lino"},/area/innie_base)
"an" = (/turf/unsimulated/wall/fakeglass,/area/innie_base)
"ao" = (/turf/unsimulated/floor{icon = 'icons/turf/shuttle.dmi'; icon_state = "floor3"},/area/innie_base)
"ap" = (/obj/machinery/light{tag = "icon-tube1 (NORTH)"; icon_state = "tube1"; dir = 1},/turf/unsimulated/floor{icon = 'icons/turf/shuttle.dmi'; icon_state = "floor3"},/area/innie_base)
"aq" = (/obj/structure/window/reinforced/tinted{dir = 8; icon_state = "twindow"},/obj/structure/table/glass,/obj/item/weapon/circular_saw,/obj/item/weapon/surgicaldrill,/turf/unsimulated/floor{icon = 'icons/turf/shuttle.dmi'; icon_state = "floor3"},/area/innie_base)
"ar" = (/obj/structure/table/glass,/obj/item/weapon/FixOVein,/obj/item/stack/medical/advanced/bruise_pack,/turf/unsimulated/floor{icon = 'icons/turf/shuttle.dmi'; icon_state = "floor3"},/area/innie_base)
"as" = (/obj/machinery/computer3/operating,/turf/unsimulated/floor{icon = 'icons/turf/shuttle.dmi'; icon_state = "floor3"},/area/innie_base)
"at" = (/obj/structure/table/rack,/turf/unsimulated/floor{dir = 2; icon_state = "dark"},/area/innie_base)
"au" = (/obj/machinery/bodyscanner,/turf/unsimulated/floor{icon = 'icons/turf/shuttle.dmi'; icon_state = "floor3"},/area/innie_base)
"av" = (/obj/machinery/body_scanconsole,/turf/unsimulated/floor{icon = 'icons/turf/shuttle.dmi'; icon_state = "floor3"},/area/innie_base)
"aw" = (/obj/structure/window/reinforced/tinted{dir = 8; icon_state = "twindow"},/obj/structure/table/glass,/obj/item/weapon/bonegel,/obj/item/weapon/bonesetter,/turf/unsimulated/floor{icon = 'icons/turf/shuttle.dmi'; icon_state = "floor3"},/area/innie_base)
"ax" = (/obj/machinery/optable,/turf/unsimulated/floor{icon = 'icons/turf/shuttle.dmi'; icon_state = "floor3"},/area/innie_base)
"ay" = (/obj/machinery/iv_drip,/turf/unsimulated/floor{icon = 'icons/turf/shuttle.dmi'; icon_state = "floor3"},/area/innie_base)
"az" = (/obj/machinery/light{icon_state = "tube1"; dir = 8},/turf/unsimulated/floor{dir = 2; icon_state = "dark"},/area/innie_base)
"aA" = (/obj/machinery/light{icon_state = "tube1"; dir = 8},/turf/unsimulated/floor{icon = 'icons/turf/shuttle.dmi'; icon_state = "floor3"},/area/innie_base)
"aB" = (/obj/structure/window/reinforced/tinted{dir = 8; icon_state = "twindow"},/obj/structure/table/glass,/obj/item/weapon/cautery,/obj/item/weapon/hemostat,/obj/item/weapon/scalpel,/obj/item/weapon/retractor,/obj/structure/window/reinforced/tinted,/turf/unsimulated/floor{icon = 'icons/turf/shuttle.dmi'; icon_state = "floor3"},/area/innie_base)
"aC" = (/obj/machinery/door/window/southleft,/turf/unsimulated/floor{icon = 'icons/turf/shuttle.dmi'; icon_state = "floor3"},/area/innie_base)
"aD" = (/obj/structure/window/reinforced/tinted,/turf/unsimulated/floor{icon = 'icons/turf/shuttle.dmi'; icon_state = "floor3"},/area/innie_base)
"aE" = (/obj/structure/table/rack,/obj/item/clothing/accessory/storage/black_vest,/obj/item/clothing/accessory/storage/black_vest,/turf/unsimulated/floor{dir = 2; icon_state = "dark"},/area/innie_base)
"aF" = (/obj/structure/table/rack,/obj/item/weapon/gun/projectile/automatic/assault,/obj/item/weapon/gun/projectile/automatic/assault,/obj/item/weapon/gun/projectile/automatic/assault,/obj/item/weapon/gun/projectile/automatic/assault,/obj/item/weapon/gun/projectile/automatic/assault,/obj/item/weapon/gun/projectile/automatic/assault,/obj/item/ammo_magazine/assault,/obj/item/ammo_magazine/assault,/obj/item/ammo_magazine/assault,/obj/item/ammo_magazine/assault,/obj/item/ammo_magazine/assault,/obj/item/ammo_magazine/assault,/obj/item/ammo_magazine/assault,/obj/item/ammo_magazine/assault,/obj/item/ammo_magazine/assault,/obj/item/ammo_magazine/assault,/obj/item/ammo_magazine/assault,/obj/item/ammo_magazine/assault,/turf/unsimulated/floor{dir = 2; icon_state = "dark"},/area/innie_base)
"aG" = (/obj/machinery/sleeper,/turf/unsimulated/floor{icon = 'icons/turf/shuttle.dmi'; icon_state = "floor3"},/area/innie_base)
"aH" = (/obj/structure/sink{dir = 4; icon_state = "sink"; pixel_x = 11; pixel_y = 0},/turf/unsimulated/floor{icon = 'icons/turf/shuttle.dmi'; icon_state = "floor3"},/area/innie_base)
"aI" = (/obj/structure/table/rack,/obj/item/weapon/storage/box/anti_photons,/obj/item/weapon/storage/box/flashbangs,/obj/machinery/light{dir = 4; icon_state = "tube1"},/turf/unsimulated/floor{dir = 2; icon_state = "dark"},/area/innie_base)
"aJ" = (/obj/structure/table/rack,/obj/item/clothing/accessory/storage/brown_vest,/obj/item/clothing/accessory/storage/brown_vest,/obj/machinery/light{icon_state = "tube1"; dir = 8},/turf/unsimulated/floor{dir = 2; icon_state = "dark"},/area/innie_base)
"aK" = (/obj/structure/table/rack,/obj/item/weapon/gun/projectile/shotgun/pump/combat,/obj/item/weapon/gun/projectile/shotgun/pump/combat,/obj/item/ammo_casing/shotgun/pellet,/obj/item/ammo_casing/shotgun/pellet,/obj/item/ammo_casing/shotgun/pellet,/obj/item/ammo_casing/shotgun/pellet,/obj/item/ammo_casing/shotgun/pellet,/obj/item/ammo_casing/shotgun/pellet,/obj/item/ammo_casing/shotgun/pellet,/obj/item/ammo_casing/shotgun/pellet,/obj/item/ammo_casing/shotgun/pellet,/obj/item/ammo_casing/shotgun/pellet,/obj/item/ammo_casing/shotgun/pellet,/obj/item/ammo_casing/shotgun/pellet,/obj/item/ammo_casing/shotgun/pellet,/obj/item/ammo_casing/shotgun/pellet,/obj/item/ammo_casing/shotgun/pellet,/obj/item/ammo_casing/shotgun/pellet,/obj/item/ammo_casing/shotgun/pellet,/turf/unsimulated/floor{dir = 2; icon_state = "dark"},/area/innie_base)
"aL" = (/obj/structure/table/glass,/obj/item/weapon/storage/firstaid/regular,/turf/unsimulated/floor{icon = 'icons/turf/shuttle.dmi'; icon_state = "floor3"},/area/innie_base)
"aM" = (/obj/structure/table/glass,/obj/item/weapon/storage/firstaid/fire,/turf/unsimulated/floor{icon = 'icons/turf/shuttle.dmi'; icon_state = "floor3"},/area/innie_base)
"aN" = (/obj/structure/table/glass,/obj/item/weapon/storage/firstaid/o2,/turf/unsimulated/floor{icon = 'icons/turf/shuttle.dmi'; icon_state = "floor3"},/area/innie_base)
"aO" = (/obj/structure/table/glass,/obj/item/weapon/storage/firstaid/toxin,/turf/unsimulated/floor{icon = 'icons/turf/shuttle.dmi'; icon_state = "floor3"},/area/innie_base)
"aP" = (/obj/machinery/light{dir = 4; icon_state = "tube1"},/turf/unsimulated/floor{icon = 'icons/turf/shuttle.dmi'; icon_state = "floor3"},/area/innie_base)
"aQ" = (/obj/machinery/recharger/wallcharger{pixel_x = -25},/turf/unsimulated/floor{dir = 2; icon_state = "dark"},/area/innie_base)
"aR" = (/obj/structure/table/rack,/obj/item/weapon/tank/emergency_oxygen/double,/obj/item/weapon/tank/emergency_oxygen/double,/obj/item/weapon/tank/emergency_oxygen/double,/obj/item/weapon/tank/emergency_oxygen/double,/obj/item/weapon/tank/emergency_oxygen/double,/obj/item/weapon/tank/emergency_oxygen/double,/turf/unsimulated/floor{dir = 2; icon_state = "dark"},/area/innie_base)
"aS" = (/turf/unsimulated/wall/fakeglass{dir = 1; icon_state = "fakewindows"},/area/innie_base)
"aT" = (/obj/machinery/light{dir = 4; icon_state = "tube1"},/turf/unsimulated/floor{dir = 2; icon_state = "dark"},/area/innie_base)
"aU" = (/obj/structure/table/rack,/obj/machinery/recharger/wallcharger{pixel_x = -25},/turf/unsimulated/floor{dir = 2; icon_state = "dark"},/area/innie_base)
"aV" = (/obj/structure/table/rack,/obj/item/weapon/gun/projectile/magnum,/obj/item/weapon/gun/projectile/magnum,/obj/item/weapon/gun/projectile/magnum,/obj/item/weapon/gun/projectile/magnum,/obj/item/weapon/gun/projectile/magnum,/obj/item/weapon/gun/projectile/magnum,/obj/item/ammo_magazine/magnum,/obj/item/ammo_magazine/magnum,/obj/item/ammo_magazine/magnum,/obj/item/ammo_magazine/magnum,/obj/item/ammo_magazine/magnum,/obj/item/ammo_magazine/magnum,/obj/item/ammo_magazine/magnum,/obj/item/ammo_magazine/magnum,/obj/item/ammo_magazine/magnum,/obj/item/ammo_magazine/magnum,/obj/item/ammo_magazine/magnum,/obj/item/ammo_magazine/magnum,/turf/unsimulated/floor{dir = 2; icon_state = "dark"},/area/innie_base)
"aW" = (/turf/unsimulated/wall/fakeglass{icon_state = "fakewindows2"; dir = 1},/area/innie_base)
"aX" = (/obj/machinery/door/airlock/centcom{name = "Barracks"; req_access = list(150)},/turf/unsimulated/floor{dir = 2; icon_state = "dark"},/area/innie_base)
"aY" = (/obj/machinery/door/airlock/glass{name = "Medical Facility"; req_access = list(150)},/turf/unsimulated/floor{icon = 'icons/turf/shuttle.dmi'; icon_state = "floor3"},/area/innie_base)
"aZ" = (/obj/structure/grille,/obj/structure/window/reinforced{dir = 4},/obj/structure/window/reinforced{dir = 8},/turf/simulated/floor/plating,/area/innie_base)
"ba" = (/obj/machinery/light,/turf/unsimulated/floor{icon = 'icons/turf/shuttle.dmi'; icon_state = "floor3"},/area/innie_base)
"bb" = (/obj/machinery/door/airlock/multi_tile/glass{autoclose = 1; dir = 2; name = "Armory"; req_access = list(150)},/turf/unsimulated/floor{dir = 2; icon_state = "dark"},/area/innie_base)
"bc" = (/obj/machinery/light,/turf/unsimulated/floor{dir = 2; icon_state = "dark"},/area/innie_base)
"bd" = (/obj/structure/table/rack,/obj/item/clothing/suit/space/syndicate/black/green,/obj/item/clothing/head/helmet/space/syndicate/black/green,/obj/item/clothing/suit/storage/vest/heavy/merc,/turf/unsimulated/floor{dir = 2; icon_state = "dark"},/area/innie_base)
"be" = (/obj/structure/table/rack,/obj/item/weapon/tank/jetpack/oxygen,/obj/item/weapon/tank/jetpack/oxygen,/obj/machinery/light,/turf/unsimulated/floor{dir = 2; icon_state = "dark"},/area/innie_base)
"bf" = (/obj/structure/table/rack,/obj/item/clothing/suit/space/syndicate/black/blue,/obj/item/clothing/head/helmet/space/syndicate/black/blue,/obj/item/clothing/suit/storage/vest/heavy/merc,/turf/unsimulated/floor{dir = 2; icon_state = "dark"},/area/innie_base)
"bg" = (/obj/structure/table/rack,/obj/item/weapon/tank/jetpack/oxygen,/obj/machinery/light,/turf/unsimulated/floor{dir = 2; icon_state = "dark"},/area/innie_base)
"bh" = (/obj/structure/table/rack,/obj/item/clothing/suit/space/syndicate/black/orange,/obj/item/clothing/head/helmet/space/syndicate/black/orange,/obj/item/clothing/suit/storage/vest/heavy/merc,/turf/unsimulated/floor{dir = 2; icon_state = "dark"},/area/innie_base)
"bi" = (/obj/machinery/embedded_controller/radio/simple_docking_controller{id_tag = "innie_base"; pixel_x = 25},/turf/unsimulated/floor{dir = 2; icon_state = "dark"},/area/innie_base)
"bj" = (/obj/machinery/door/airlock/external{frequency = 1379; id_tag = "innie_base_hatch"; name = "Shuttle"; req_access = list(150)},/turf/unsimulated/floor{dir = 2; icon_state = "dark"},/area/innie_base)
"bk" = (/obj/structure/shuttle/engine/propulsion{icon_state = "propulsion"; dir = 1},/turf/space,/area/innie_base/shuttle)
"bl" = (/turf/simulated/shuttle/wall{dir = 8; icon_state = "diagonalWall3"},/area/innie_base/shuttle)
"bm" = (/turf/simulated/shuttle/wall{icon_state = "pwall"; dir = 1},/area/innie_base/shuttle)
"bn" = (/obj/machinery/door/airlock/external{frequency = 1379; id_tag = "innie_shuttle_outer"; name = "Shuttle"; req_access = list(150)},/obj/machinery/door/blast/regular/open{id = "sinnie"},/turf/simulated/shuttle/plating,/area/innie_base/shuttle)
"bo" = (/turf/simulated/shuttle/wall{dir = 1; icon_state = "diagonalWall3"},/area/innie_base/shuttle)
"bp" = (/obj/structure/shuttle/engine/heater{icon_state = "heater"; dir = 1},/turf/simulated/shuttle/wall{icon_state = "pwall"; dir = 1},/area/innie_base/shuttle)
"bq" = (/turf/simulated/shuttle/floor{icon_state = "floor4"},/area/innie_base/shuttle)
"br" = (/turf/simulated/shuttle/wall{icon_state = "diagonalWall3"},/area/innie_base/shuttle)
"bs" = (/obj/structure/window/shuttle{icon_state = "window4"},/turf/simulated/shuttle/floor{icon_state = "floor2"},/area/innie_base/shuttle)
"bt" = (/obj/structure/window/shuttle{icon_state = "window12"},/turf/simulated/shuttle/floor{icon_state = "floor2"},/area/innie_base/shuttle)
"bu" = (/obj/structure/window/shuttle{icon_state = "window8"},/turf/simulated/shuttle/floor{icon_state = "floor2"},/area/innie_base/shuttle)
"bv" = (/obj/machinery/door/airlock/glass,/turf/simulated/shuttle/floor{icon_state = "floor2"},/area/innie_base/shuttle)
"bw" = (/turf/simulated/shuttle/wall{dir = 4; icon_state = "diagonalWall3"},/area/innie_base/shuttle)
"bx" = (/obj/structure/window/shuttle{icon_state = "window2"},/turf/space,/area/innie_base/shuttle)
"by" = (/turf/simulated/shuttle/floor{icon_state = "floor2"},/area/innie_base/shuttle)
"bz" = (/obj/structure/window/shuttle{icon_state = "window3"},/turf/space,/area/innie_base/shuttle)
"bA" = (/obj/structure/window/shuttle{icon_state = "window1"},/turf/space,/area/innie_base/shuttle)
"bB" = (/turf/space,/turf/simulated/shuttle/wall{dir = 8; icon_state = "diagonalWall3"},/area/innie_base/shuttle)
"bC" = (/obj/structure/window/shuttle,/turf/simulated/shuttle/floor{icon_state = "floor2"},/area/innie_base/shuttle)
"bD" = (/obj/machinery/door/airlock/command,/turf/simulated/shuttle/floor{icon_state = "floor2"},/area/innie_base/shuttle)
"bE" = (/turf/space,/turf/simulated/shuttle/wall{dir = 1; icon_state = "diagonalWall3"},/area/innie_base/shuttle)
"bF" = (/turf/simulated/shuttle/floor,/turf/simulated/shuttle/wall{dir = 4; icon_state = "diagonalWall3"},/area/innie_base/shuttle)
"bG" = (/turf/simulated/shuttle/floor,/area/innie_base/shuttle)
"bH" = (/turf/simulated/shuttle/floor,/turf/simulated/shuttle/wall{icon_state = "diagonalWall3"},/area/innie_base/shuttle)
"bI" = (/obj/structure/window/shuttle{icon_state = "window4"},/turf/space,/area/innie_base/shuttle)
"bJ" = (/obj/structure/window/shuttle{icon_state = "window12"},/turf/space,/area/innie_base/shuttle)
"bK" = (/obj/structure/window/shuttle{icon_state = "window8"},/turf/space,/area/innie_base/shuttle)

(1,1,1) = {"
aaaaaaaaaaaaaaaaaaaaaaaaaaaaaaaaaaaaaaaaaaaaaaaaaaaaaaaaaaaaaaaaaaaaaaaaaaaaaaaaaaaaaaaaaaaaaaaaaaaaaaaaaaaaaaaaaaaaaaaaaaaaaaaa
aaaaaaaaaaaaaaaaaaaaaaaaaaaaaaaaaaaaaaaaaaaaaaaaaaaaaaaaaaaaaaaaaaaaaaaaaaaaaaaaaaaaaaaaaaaaaaaaaaaaaaaaaaaaaaaaaaaaaaaaaaaaaaaa
aaaaaaaaaaaaaaaaaaaaaaaaaaaaaaaaaaaaaaaaaaaaaaaaaaaaaaaaaaaaaaaaaaaaaaaaaaaaaaaaaaaaaaaaaaaaaaaaaaaaaaaaaaaaaaaaaaaaaaaaaaaaaaaa
aaaaaaaaaaaaaaaaaaaaaaaaaaaaaaaaaaaaaaaaaaaaaaaaaaaaaaaaaaaaaaaaaaaaaaaaaaaaaaaaaaaaaaaaaaaaaaaaaaaaaaaaaaaaaaaaaaaaaaaaaaaaaaaa
aaaaaaaaaaaaaaaaaaaaaaaaaaaaaaaaaaaaaaaaaaaaaaaaaaaaaaaaaaaaaaaaaaaaaaaaaaaaaaaaaaaaaaaaaaaaaaaaaaaaaaaaaaaaaaaaaaaaaaaaaaaaaaaa
aaaaaaaaaaaaaaaaaaaaaaaaaaaaaaaaaaaaaaaaaaaaaaaaaaaaaaaaaaaaaaaaaaaaaaaaaaaaaaaaaaaaaaaaaaaaaaaaaaaaaaaaaaaaaaaaaaaaaaaaaaaaaaaa
aaaaaaaaaaaaaaaaaaaaaaaaaaaaaaaaaaaaaaaaaaaaaaaaaaaaaaaaaaaaaaaaaaaaaaaaaaaaaaaaaaaaaaaaaaaaaaaaaaaaaaaaaaaaaaaaaaaaaaaaaaaaaaaa
aaaaaaaaaaaaaaaaaaaaaaaaaaaaaaaaaaaaaaaaaaaaaaaaaaaaaaaaaaaaaaaaaaaaaaaaaaaaaaaaaaaaaaaaaaaaaaaaaaaaaaaaaaaaaaaaaaaaaaaaaaaaaaaa
aaaaaaaaaaaaaaaaaaaaaaaaaaaaaaaaaaaaaaaaaaaaaaaaaaaaaaaaaaaaaaaaaaaaaaaaaaaaaaaaaaaaaaaaaaaaaaaaaaaaaaaaaaaaaaaaaaaaaaaaaaaaaaaa
aaaaaaaaaaaaaaaaaaaaaaaaaaaaaaaaaaaaaaaaaaaaaaaaaaaaaaaaaaaaaaaaaaaaaaaaaaaaaaaaaaaaaaaaaaaaaaaaaaaaaaaaaaaaaaaaaaaaaaaaaaaaaaaa
aaaaaaaaaaaaaaaaaaaaaaaaaaaaaaaaaaaaaaaaaaaaaaaaaaaaaaaaaaaaaaaaaaaaaaaaaaaaaaaaaaaaaaaaaaaaaaaaaaaaaaaaaaaaaaaaaaaaaaaaaaaaaaaa
aaaaaaaaaaaaaaaaaaaaaaaaaaaaaaaaaaaaaaaaaaaaaaaaaaaaaaaaaaaaaaaaaaaaaaaaaaaaaaaaaaaaaaaaaaaaaaaaaaaaaaaaaaaaaaaaaaaaaaaaaaaaaaaa
aaaaaaaaaaaaaaaaaaaaaaaaaaaaaaaaaaaaaaaaaaaaaaaaaaaaaaaaaaaaaaaaaaaaaaaaaaaaaaaaaaaaaaaaaaaaaaaaaaaaaaaaaaaaaaaaaaaaaaaaaaaaaaaa
aaaaaaaaaaaaaaaaaaaaaaaaaaaaaaaaaaaaaaaaaaaaaaaaaaaaaaaaaaaaaaaaaaaaaaaaaaaaaaaaaaaaaaaaaaaaaaaaaaaaaaaaaaaaaaaaaaaaaaaaaaaaaaaa
aaaaaaaaaaaaaaaaaaaaaaaaaaaaaaaaaaaaaaaaaaaaaaaaaaaaaaaaaaaaaaaaaaaaaaaaaaaaaaaaaaaaaaaaaaaaaaaaaaaaaaaaaaaaaaaaaaaaaaaaaaaaaaaa
aaaaaaaaaaaaaaaaaaaaaaaaaaaaaaaaaaaaaaaaaaaaaaaaaaaaaaaaaaaaaaaaaaaaaaaaaaaaaaaaaaaaaaaaaaaaaaaaaaaaaaaaaaaaaaaaaaaaaaaaaaaaaaaa
aaaaaaaaaaaaaaaaaaaaaaaaaaaaaaaaaaaaaaaaaaaaaaaaaaaaaaaaaaaaaaaaaaaaaaaaaaaaaaaaaaaaaaaaaaaaaaaaaaaaaaaaaaaaaaaaaaaaaaaaaaaaaaaa
aaaaaaaaaaaaaaaaaaaaaaaaaaaaaaaaaaaaaaaaaaaaaaaaaaaaaaaaaaaaaaaaaaaaaaaaaaaaaaaaaaaaaaaaaaaaaaaaaaaaaaaaaaaaaaaaaaaaaaaaaaaaaaaa
aaaaaaaaaaaaaaaaaaaaaaaaaaaaaaaaaaaaaaaaaaaaaaaaaaaaaaaaaaaaaaaaaaaaaaaaaaaaaaaaaaaaaaaaaaabaaaaaaaaaaaaaaaaaaaaaaaaaaaaaaaaaaaa
aaaaaaaaaaaaaaaaaaaaaaaaaaaaaaaaaaaaaaaaaaaaaaabababababababababababababaaaaaaaaaaaaaaaaababaaaaaaaaaaaaaaaaaaaaaaaaaaaaaaaaaaaa
aaaaaaaaaaaaaaaaaaaaaaaaaaaaaaaaaaaaaaaaaaaaababababababababababababababababababababababababaaaaaaaaaaaaaaaaaaaaaaaaaaaaaaaaaaaa
aaaaaaaaaaaaaaaaaaaaaaaaaaaaaaaaaaaaaaaaaaaaababababababababababababababababababababababababaaaaaaaaaaaaaaaaaaaaaaaaaaaaaaaaaaaa
aaaaaaaaaaaaaaaaaaaaaaaaaaaaaaaaaaaaaaaaaaababababababacacacacacabababacacacacacacacacacababaaaaaaaaaaaaaaaaaaaaaaaaaaaaaaaaaaaa
aaaaaaaaaaaaaaaaaaaaaaaaaaaaaaaaaaaaaaabababababababacacadaeafacacababacagahahahahahagacababaaaaaaaaaaaaaaaaaaaaaaaaaaaaaaaaaaaa
aaaaaaaaaaaaaaaaaaaaaaaaaaaaaaaaaaaiajacacacacacacacacakalamalakacababacahahahahahahahacabababaaaaaaaaaaaaaaaaaaaaaaaaaaaaaaaaaa
aaaaaaaaaaaaaaaaaaaaaaaaaaaaaaaaaaanaoapaoaqarasapacacakalamalakacababacatahahahahahatacabababaaaaaaaaaaaaaaaaaaaaaaaaaaaaaaaaaa
aaaaaaaaaaaaaaaaaaaaaaaaaaaaaaaaabacauavaoawaoaxayacacakalamalakacababacazahahahahahahacabababaaaaaaaaaaaaaaaaaaaaaaaaaaaaaaaaaa
aaaaaaaaaaaaaaaaaaaaaaaaaaaaaaaaabacaAaoaoaBaCaDaDacacacalamalacacababacaEahahahahahaFacabababaaaaaaaaaaaaaaaaaaaaaaaaaaaaaaaaaa
aaaaaaaaaaaaaaaaaaaaaaaaaaaaaaaaabacaGaoaoaoaoaoaHacabacazahahacabababacahahahahahahaIacabaaaaaaaaaaaaaaaaaaaaaaaaaaaaaaaaaaaaaa
aaaaaaaaaaaaaaaaaaaaaaaaaaaaaaaaabacaoaoaoaoaoaoaoacabacahahahacabababacaJahahahahahaKacabaaaaaaaaaaaaaaaaaaaaaaaaaaaaaaaaaaaaaa
aaaaaaaaaaaaaaaaaaaaaaaaaaaaaaaaabacaLaMaNaOaoaoaPacabacahahahacabababacaQahahahahahaRaSaaaaaaaaaaaaaaaaaaaaaaaaaaaaaaaaaaaaaaaa
aaaaaaaaaaaaaaaaaaaaaaaaaaaaaaaaabacacacacacaoaoacacabacahahaTacabababacaUahahahahahaVaWaaaaaaaaaaaaaaaaaaaaaaaaaaaaaaaaaaaaaaaa
aaaaaaaaaaaaaaaaaaaaaaaaaaaaaaaaabababababacaoaoacacacacacaXacacacacacacaQahahahahahahaWaaaaaaaaaaaaaaaaaaaaaaaaaaaaaaaaaaaaaaaa
aaaaaaaaaaaaaaaaaaaaaaaaaaaaaaaaabababababacaoaoaYahagahahahahahahagahaZahahahahahahahaWaaaaaaaaaaaaaaaaaaaaaaaaaaaaaaaaaaaaaaaa
aaaaaaaaaaaaaaaaaaaaaaaaaaaaaaaaaaababababacbaaoaYahahahahahahahahahahahahahahahahahahaWaaaaaaaaaaaaaaaaaaaaaaaaaaaaaaaaaaaaaaaa
aaaaaaaaaaaaaaaaaaaaaaaaaaaaaaaaaaaaabababacacacacahahahahahahahahahahbbahahahahahahahaWaaaaaaaaaaaaaaaaaaaaaaaaaaaaaaaaaaaaaaaa
aaaaaaaaaaaaaaaaaaaaaaaaaaaaaaaaaaaaaaabababababacahahahahahbcahahahahaZahbdbebfbgbhahanaaaaaaaaaaaaaaaaaaaaaaaaaaaaaaaaaaaaaaaa
aaaaaaaaaaaaaaaaaaaaaaaaaaaaaaaaaaaaaaaaaaaaababacacacacacacacacahaTacacacacacacacacacacaaaaaaaaaaaaaaaaaaaaaaaaaaaaaaaaaaaaaaaa
aaaaaaaaaaaaaaaaaaaaaaaaaaaaaaaaaaaaaaaaaaaaaaaaaaaaabababababacahahacabababababababaaaaaaaaaaaaaaaaaaaaaaaaaaaaaaaaaaaaaaaaaaaa
aaaaaaaaaaaaaaaaaaaaaaaaaaaaaaaaaaaaaaaaaaaaaaaaaaaaaaababababacahahacabababababababaaaaaaaaaaaaaaaaaaaaaaaaaaaaaaaaaaaaaaaaaaaa
aaaaaaaaaaaaaaaaaaaaaaaaaaaaaaaaaaaaaaaaaaaaaaaaaaaaaaaaaaababacahahacababababababaaaaaaaaaaaaaaaaaaaaaaaaaaaaaaaaaaaaaaaaaaaaaa
aaaaaaaaaaaaaaaaaaaaaaaaaaaaaaaaaaaaaaaaaaaaaaaaaaaaaaaaaaaaabacahahacababababaaaaaaaaaaaaaaaaaaaaaaaaaaaaaaaaaaaaaaaaaaaaaaaaaa
aaaaaaaaaaaaaaaaaaaaaaaaaaaaaaaaaaaaaaaaaaaaaaaaaaaaaaaaaaaaaaacazbiacabababaaaaaaaaaaaaaaaaaaaaaaaaaaaaaaaaaaaaaaaaaaaaaaaaaaaa
aaaaaaaaaaaaaaaaaaaaaaaaaaaaaaaaaaaaaaaaaaaaaaaaaaaaaaaaaaaaaaacbjbjacababaaaaaaaaaaaaaaaaaaaaaaaaaaaaaaaaaaaaaaaaaaaaaaaaaaaaaa
aaaaaaaaaaaaaaaaaaaaaaaaaaaaaaaaaaaaaaaaaaaaaaaaaaaaaaaaaaaaaaacahahacababaaaaaaaaaaaaaaaaaaaaaaaaaaaaaaaaaaaaaaaaaaaaaaaaaaaaaa
aaaaaaaaaaaaaaaaaaaaaaaaaaaaaaaaaaaaaaaaaaaaaaaaaaaaaaaaaaaaaaacbjbjacababaaaaaaaaaaaaaaaaaaaaaaaaaaaaaaaaaaaaaaaaaaaaaaaaaaaaaa
aaaaaaaaaaaaaaaaaaaaaaaaaaaaaaaaaaaaaaaabkbkbkbkbkbkblbmbmbmbmbmbnbnbmbmbmbmbmbobkbkbkbkbkbkaaaaaaaaaaaaaaaaaaaaaaaaaaaaaaaaaaaa
aaaaaaaaaaaaaaaaaaaaaaaaaaaaaaaaaaaaaaaabpbpbpbpbpbpbmbqbqbqbqbqbqbqbqbqbqbqbqbmbpbpbpbpbpbpaaaaaaaaaaaaaaaaaaaaaaaaaaaaaaaaaaaa
aaaaaaaaaaaaaaaaaaaaaaaaaaaaaaaaaaaaaaaaaabmbmbmbmbmbmbqbqbqbqbqbqbqbqbqbqbqbqbmbmbmbmbmbmaaaaaaaaaaaaaaaaaaaaaaaaaaaaaaaaaaaaaa
aaaaaaaaaaaaaaaaaaaaaaaaaaaaaaaaaaaaaaaaaaaabmbmbmbmbmbqbqbqbqbqbqbqbqbqbqbqbqbmbmbmbmbmaaaaaaaaaaaaaaaaaaaaaaaaaaaaaaaaaaaaaaaa
aaaaaaaaaaaaaaaaaaaaaaaaaaaaaaaaaaaaaaaaaaaaaabmbmbmbmbqbqbqbqbqbqbqbqbqbqbqbqbmbmbmbmaaaaaaaaaaaaaaaaaaaaaaaaaaaaaaaaaaaaaaaaaa
aaaaaaaaaaaaaaaaaaaaaaaaaaaaaaaaaaaaaaaaaaaaaaaabmbmbmbqbqbqbqbqbqbqbqbqbqbqbqbmbmbmaaaaaaaaaaaaaaaaaaaaaaaaaaaaaaaaaaaaaaaaaaaa
aaaaaaaaaaaaaaaaaaaaaaaaaaaaaaaaaaaaaaaaaaaaaaaaaabmbmbqbqbqbqbqbqbqbqbqbqbqbqbmbmaaaaaaaaaaaaaaaaaaaaaaaaaaaaaaaaaaaaaaaaaaaaaa
aaaaaaaaaaaaaaaaaaaaaaaaaaaaaaaaaaaaaaaaaaaaaaaaaaaabrbmbsbtbtbubvbvbsbtbtbubmbwaaaaaaaaaaaaaaaaaaaaaaaaaaaaaaaaaaaaaaaaaaaaaaaa
aaaaaaaaaaaaaaaaaaaaaaaaaaaaaaaaaaaaaaaaaaaaaaaaaaaaaabxbybybybybybybybybybybxaaaaaaaaaaaaaaaaaaaaaaaaaaaaaaaaaaaaaaaaaaaaaaaaaa
aaaaaaaaaaaaaaaaaaaaaaaaaaaaaaaaaaaaaaaaaaaaaaaaaaaaaabzbybybybybybybybybybybzaaaaaaaaaaaaaaaaaaaaaaaaaaaaaaaaaaaaaaaaaaaaaaaaaa
aaaaaaaaaaaaaaaaaaaaaaaaaaaaaaaaaaaaaaaaaaaaaaaaaaaaaabAbybybybybybybybybybybAaaaaaaaaaaaaaaaaaaaaaaaaaaaaaaaaaaaaaaaaaaaaaaaaaa
aaaaaaaaaaaaaaaaaaaaaaaaaaaaaaaaaaaaaaaaaaaaaaaaaaaabBbmbmbmbmbCbDbDbCbmbmbmbmbEaaaaaaaaaaaaaaaaaaaaaaaaaaaaaaaaaaaaaaaaaaaaaaaa
aaaaaaaaaaaaaaaaaaaaaaaaaaaaaaaaaaaaaaaaaaaaaaaaaaaabmbFbGbGbGbGbGbGbGbGbGbGbHbmaaaaaaaaaaaaaaaaaaaaaaaaaaaaaaaaaaaaaaaaaaaaaaaa
aaaaaaaaaaaaaaaaaaaaaaaaaaaaaaaaaaaaaaaaaaaaaaaaaaaabxbGbGbGbGbGbGbGbGbGbGbGbGbAaaaaaaaaaaaaaaaaaaaaaaaaaaaaaaaaaaaaaaaaaaaaaaaa
aaaaaaaaaaaaaaaaaaaaaaaaaaaaaaaaaaaaaaaaaaaaaaaaaaaabzbGbGbGbGbGbGbGbGbGbGbGbGbzaaaaaaaaaaaaaaaaaaaaaaaaaaaaaaaaaaaaaaaaaaaaaaaa
aaaaaaaaaaaaaaaaaaaaaaaaaaaaaaaaaaaaaaaaaaaaaaaaaaaabzbGbGbGbGbGbGbGbGbGbGbGbGbzaaaaaaaaaaaaaaaaaaaaaaaaaaaaaaaaaaaaaaaaaaaaaaaa
aaaaaaaaaaaaaaaaaaaaaaaaaaaaaaaaaaaaaaaaaaaaaaaaaaaabAbGbGbGbGbGbGbGbGbGbGbGbGbAaaaaaaaaaaaaaaaaaaaaaaaaaaaaaaaaaaaaaaaaaaaaaaaa
aaaaaaaaaaaaaaaaaaaaaaaaaaaaaaaaaaaaaaaaaaaaaaaaaaaabmbIbJbJbJbJbJbJbJbJbJbJbKbmaaaaaaaaaaaaaaaaaaaaaaaaaaaaaaaaaaaaaaaaaaaaaaaa
"}
