"a" = (/turf/space,/area/space)
"b" = (/turf/simulated/mineral,/area/space)
"c" = (/turf/simulated/mineral/random/high_chance,/area/space)
"d" = (/turf/simulated/mineral/random,/area/space)
"e" = (/obj/effect/overmapinfo/precreated/meteors,/turf/space,/area/space)

(1,1,1) = {"
aabbbbbbcb
aabbcccccc
aabbbbbbbc
aaabbbdccc
aaabbbdcbb
aaaabbddbb
aaaabbbbbb
aaaabbbbbb
aaaaabbbbb
eaaaaaabbb
"}
