"a" = (/obj/effect/mapinfo/precreated/radiate,/turf/space,/area/space)

(1,1,1) = {"
a
"}
