"a" = (/obj/effect/overmapinfo/precreated/radiate,/turf/space,/area/space)

(1,1,1) = {"
a
"}
