"a" = (/turf/unsimulated/blocker,/area/space)
"b" = (/turf/simulated/shuttle/hull{dir = 8; icon_state = "diagonalWall3"},/area/space)
"c" = (/turf/simulated/shuttle/hull/window{icon = 'icons/obj/structures.dmi'; icon_state = "r-wingrille"},/area/space)
"d" = (/turf/simulated/shuttle/hull{dir = 1; icon_state = "diagonalWall3"},/area/space)
"e" = (/obj/structure/table/reinforced,/obj/effect/floor_decal/corner/red/full{dir = 8},/turf/simulated/shuttle/hull/floor{icon = 'icons/turf/flooring/tiles.dmi'; icon_state = "dark"; tag = "icon-floor6"},/area/space)
"f" = (/obj/machinery/computer/shuttle_helm,/turf/simulated/shuttle/hull/floor{icon = 'icons/turf/flooring/tiles.dmi'; icon_state = "dark"; tag = "icon-floor6"},/area/space)
"g" = (/obj/structure/table/reinforced,/obj/effect/floor_decal/corner/red/full{dir = 1},/turf/simulated/shuttle/hull/floor{icon = 'icons/turf/flooring/tiles.dmi'; icon_state = "dark"; tag = "icon-floor6"},/area/space)
"h" = (/obj/structure/table/reinforced,/obj/effect/floor_decal/corner/red{dir = 9},/turf/simulated/shuttle/hull/floor{icon = 'icons/turf/flooring/tiles.dmi'; icon_state = "dark"; tag = "icon-floor6"},/area/space)
"i" = (/obj/structure/bed/chair/comfy/black{dir = 1},/turf/simulated/shuttle/hull/floor{icon = 'icons/turf/flooring/tiles.dmi'; icon_state = "dark"; tag = "icon-floor6"},/area/space)
"j" = (/obj/structure/table/reinforced,/obj/effect/floor_decal/corner/red{dir = 6},/turf/simulated/shuttle/hull/floor{icon = 'icons/turf/flooring/tiles.dmi'; icon_state = "dark"; tag = "icon-floor6"},/area/space)
"k" = (/turf/simulated/shuttle/hull{icon_state = "wall3"},/area/space)
"l" = (/obj/effect/floor_decal/corner/red/full,/obj/machinery/alarm{dir = 4; icon_state = "alarm0"; pixel_x = -22; pixel_y = 0},/obj/machinery/light/small{brightness_color = "#DA0205"; brightness_power = 1; brightness_range = 5},/turf/simulated/shuttle/hull/floor{icon = 'icons/turf/flooring/tiles.dmi'; icon_state = "dark"; tag = "icon-floor6"},/area/space)
"m" = (/turf/simulated/shuttle/hull/floor{icon = 'icons/turf/flooring/tiles.dmi'; icon_state = "dark"; tag = "icon-floor6"},/area/space)
"n" = (/obj/effect/floor_decal/corner/red/full{dir = 4},/obj/machinery/recharger/wallcharger{pixel_x = 30},/obj/machinery/light/small{brightness_color = "#DA0205"; brightness_power = 1; brightness_range = 5},/turf/simulated/shuttle/hull/floor{icon = 'icons/turf/flooring/tiles.dmi'; icon_state = "dark"; tag = "icon-floor6"},/area/space)
"o" = (/obj/machinery/door/airlock/glass_security,/turf/simulated/shuttle/hull/floor{icon = 'icons/turf/flooring/tiles.dmi'; icon_state = "dark"; tag = "icon-floor6"},/area/space)
"p" = (/obj/structure/turret/gun_turret{dir = 1; pixel_y = 0},/turf/simulated/shuttle/hull{icon_state = "wall3"},/area/space)
"q" = (/obj/effect/floor_decal/corner/red/full{dir = 8},/obj/machinery/power/apc{dir = 1; name = "north bump"; pixel_x = 0; pixel_y = 24},/obj/structure/table/standard,/turf/simulated/shuttle/hull/floor{icon = 'icons/turf/flooring/tiles.dmi'; icon_state = "dark"; tag = "icon-floor6"},/area/space)
"r" = (/obj/effect/floor_decal/corner/red/full{dir = 1},/obj/machinery/recharger/wallcharger{pixel_y = 25},/obj/structure/table/standard,/obj/item/weapon/storage/toolbox/mechanical,/turf/simulated/shuttle/hull/floor{icon = 'icons/turf/flooring/tiles.dmi'; icon_state = "dark"; tag = "icon-floor6"},/area/space)
"s" = (/obj/structure/bed/chair{dir = 4},/obj/effect/floor_decal/corner/red/full{dir = 8},/turf/simulated/shuttle/hull/floor{icon = 'icons/turf/flooring/tiles.dmi'; icon_state = "dark"; tag = "icon-floor6"},/area/space)
"t" = (/obj/machinery/light{dir = 1},/obj/machinery/recharger/wallcharger{pixel_y = 25},/turf/simulated/shuttle/hull/floor{icon = 'icons/turf/flooring/tiles.dmi'; icon_state = "dark"; tag = "icon-floor6"},/area/space)
"u" = (/obj/structure/bed/chair{dir = 8},/obj/effect/floor_decal/corner/red/full{dir = 1},/turf/simulated/shuttle/hull/floor{icon = 'icons/turf/flooring/tiles.dmi'; icon_state = "dark"; tag = "icon-floor6"},/area/space)
"v" = (/obj/effect/wingrille_spawn/reinforced,/turf/simulated/shuttle/hull/floor{icon = 'icons/turf/flooring/tiles.dmi'; icon_state = "dark"; tag = "icon-floor6"},/area/space)
"w" = (/obj/effect/floor_decal/corner/red{dir = 9},/obj/structure/table/standard,/obj/item/weapon/gun/energy/taser,/turf/simulated/shuttle/hull/floor{icon = 'icons/turf/flooring/tiles.dmi'; icon_state = "dark"; tag = "icon-floor6"},/area/space)
"x" = (/obj/effect/floor_decal/corner/red{dir = 6},/obj/structure/table/standard,/obj/item/weapon/storage/toolbox/electrical,/turf/simulated/shuttle/hull/floor{icon = 'icons/turf/flooring/tiles.dmi'; icon_state = "dark"; tag = "icon-floor6"},/area/space)
"y" = (/obj/structure/bed/chair{dir = 4},/obj/effect/floor_decal/corner/red{dir = 9},/obj/machinery/flasher{id = "IAflash"; pixel_x = -30; pixel_y = 0},/turf/simulated/shuttle/hull/floor{icon = 'icons/turf/flooring/tiles.dmi'; icon_state = "dark"; tag = "icon-floor6"},/area/space)
"z" = (/obj/structure/bed/chair{dir = 8},/obj/effect/floor_decal/corner/red{dir = 6},/obj/machinery/button/flasher{bound_x = 0; pixel_x = 25},/turf/simulated/shuttle/hull/floor{icon = 'icons/turf/flooring/tiles.dmi'; icon_state = "dark"; tag = "icon-floor6"},/area/space)
"A" = (/obj/effect/floor_decal/corner/red{dir = 9},/obj/structure/table/standard,/obj/item/weapon/handcuffs,/obj/item/weapon/handcuffs,/obj/machinery/light/small{dir = 8},/turf/simulated/shuttle/hull/floor{icon = 'icons/turf/flooring/tiles.dmi'; icon_state = "dark"; tag = "icon-floor6"},/area/space)
"B" = (/obj/effect/floor_decal/corner/red{dir = 6},/obj/structure/table/standard,/obj/machinery/light/small{dir = 4; pixel_y = 8},/turf/simulated/shuttle/hull/floor{icon = 'icons/turf/flooring/tiles.dmi'; icon_state = "dark"; tag = "icon-floor6"},/area/space)
"C" = (/obj/structure/bed/chair{dir = 4},/obj/effect/floor_decal/corner/red{dir = 9},/obj/machinery/button/flasher{pixel_x = -25},/turf/simulated/shuttle/hull/floor{icon = 'icons/turf/flooring/tiles.dmi'; icon_state = "dark"; tag = "icon-floor6"},/area/space)
"D" = (/obj/structure/bed/chair{dir = 8},/obj/effect/floor_decal/corner/red{dir = 6},/obj/machinery/flasher{id = "IAflash"; pixel_x = 30; pixel_y = 0},/turf/simulated/shuttle/hull/floor{icon = 'icons/turf/flooring/tiles.dmi'; icon_state = "dark"; tag = "icon-floor6"},/area/space)
"E" = (/obj/structure/bed/chair{dir = 4},/obj/effect/floor_decal/corner/red{dir = 9},/obj/machinery/alarm{dir = 4; icon_state = "alarm0"; pixel_x = -22; pixel_y = 0},/turf/simulated/shuttle/hull/floor{icon = 'icons/turf/flooring/tiles.dmi'; icon_state = "dark"; tag = "icon-floor6"},/area/space)
"F" = (/obj/structure/bed/chair{dir = 8},/obj/effect/floor_decal/corner/red{dir = 6},/obj/machinery/alarm{dir = 8; icon_state = "alarm0"; pixel_x = 24},/turf/simulated/shuttle/hull/floor{icon = 'icons/turf/flooring/tiles.dmi'; icon_state = "dark"; tag = "icon-floor6"},/area/space)
"G" = (/obj/structure/bed/chair{dir = 4},/obj/effect/floor_decal/corner/red/full,/turf/simulated/shuttle/hull/floor{icon = 'icons/turf/flooring/tiles.dmi'; icon_state = "dark"; tag = "icon-floor6"},/area/space)
"H" = (/obj/machinery/light,/obj/effect/floor_decal/corner/red{dir = 10},/turf/simulated/shuttle/hull/floor{icon = 'icons/turf/flooring/tiles.dmi'; icon_state = "dark"; tag = "icon-floor6"},/area/space)
"I" = (/obj/structure/bed/chair{dir = 8},/obj/effect/floor_decal/corner/red/full{dir = 4},/turf/simulated/shuttle/hull/floor{icon = 'icons/turf/flooring/tiles.dmi'; icon_state = "dark"; tag = "icon-floor6"},/area/space)
"J" = (/obj/effect/floor_decal/corner/red{dir = 10},/turf/simulated/shuttle/hull/floor{icon = 'icons/turf/flooring/tiles.dmi'; icon_state = "dark"; tag = "icon-floor6"},/area/space)
"K" = (/obj/machinery/door/airlock/external,/turf/simulated/shuttle/hull/floor{icon = 'icons/turf/flooring/tiles.dmi'; icon_state = "dark"; tag = "icon-floor6"},/area/space)
"L" = (/obj/machinery/access_button,/turf/simulated/shuttle/hull{icon_state = "wall3"},/area/space)
"M" = (/obj/structure/shuttle/engine/heater,/turf/simulated/shuttle/hull/floor{icon = 'icons/turf/flooring/plating.dmi'; icon_state = "plating"},/area/space)
"N" = (/obj/machinery/atmospherics/portables_connector{dir = 4},/obj/structure/window/alon{tag = "icon-window (EAST)"; icon_state = "window"; dir = 4},/obj/machinery/portable_atmospherics/canister/air/airlock,/turf/simulated/shuttle/hull/floor{icon = 'icons/turf/flooring/plating.dmi'; icon_state = "plating"},/area/space)
"O" = (/obj/machinery/atmospherics/pipe/manifold/visible{dir = 1},/obj/effect/floor_decal/industrial/warning{icon_state = "warning"; dir = 1},/turf/simulated/shuttle/hull/floor{icon = 'icons/turf/flooring/plating.dmi'; icon_state = "plating"},/area/space)
"P" = (/obj/machinery/atmospherics/pipe/simple/visible{dir = 4},/obj/machinery/light/small{dir = 1},/turf/simulated/shuttle/hull/floor{icon = 'icons/turf/flooring/plating.dmi'; icon_state = "plating"},/area/space)
"Q" = (/obj/machinery/atmospherics/portables_connector{dir = 8},/obj/structure/window/alon{tag = "icon-window (WEST)"; icon_state = "window"; dir = 8},/obj/machinery/portable_atmospherics/canister/air/airlock,/turf/simulated/shuttle/hull/floor{icon = 'icons/turf/flooring/plating.dmi'; icon_state = "plating"},/area/space)
"R" = (/turf/simulated/shuttle/hull{dir = 2; icon_state = "diagonalWall3"},/area/space)
"S" = (/obj/structure/shuttle/engine/propulsion,/turf/simulated/shuttle/hull{icon_state = "wall3"},/area/space)
"T" = (/obj/machinery/atmospherics/unary/vent_pump/high_volume{dir = 1; frequency = 1379; id_tag = "virology_pump"},/obj/structure/sign/vacuum{pixel_x = -32},/obj/effect/floor_decal/industrial/warning,/turf/simulated/shuttle/hull/floor{icon = 'icons/turf/flooring/plating.dmi'; icon_state = "plating"},/area/space)
"U" = (/turf/simulated/shuttle/hull/floor{icon = 'icons/turf/flooring/plating.dmi'; icon_state = "plating"},/area/space)
"V" = (/obj/machinery/airlock_sensor{pixel_x = 25; pixel_y = 10},/obj/machinery/atmospherics/unary/vent_pump/high_volume{dir = 1; frequency = 1379; id_tag = "virology_pump"},/obj/effect/floor_decal/industrial/warning,/obj/machinery/embedded_controller/radio/airlock/docking_port_multi{pixel_x = 25},/turf/simulated/shuttle/hull/floor{icon = 'icons/turf/flooring/plating.dmi'; icon_state = "plating"},/area/space)
"W" = (/turf/simulated/shuttle/hull{dir = 4; icon_state = "diagonalWall3"},/area/space)
"X" = (/obj/machinery/door/airlock/external/shuttle{dir = 8},/turf/simulated/shuttle/hull/floor{icon = 'icons/turf/flooring/plating.dmi'; icon_state = "plating"},/area/space)

(1,1,1) = {"
aaaabcccdaaaa
aaaacefgcaaaa
aaaachijcaaaa
aaaaklmnkaaaa
aaabkkokkdaaa
bpkkkqmrkkkpd
kstuvwmxvstuk
kymzkAmBkCmDk
kEmmommmommFk
kGHIkmJmkGHIk
kkkkkKLKkkkkk
kMMkNOPOQkMMk
RSSkkTUVkkSSW
aaaaRXLXWaaaa
"}
