"aa" = (/turf/space,/area/space)
"ab" = (/turf/simulated/wall,/area/space)
"ac" = (/obj/effect/wingrille_spawn/reinforced,/turf/simulated/floor/plating,/area/space)
"ad" = (/obj/machinery/door/airlock/external,/turf/simulated/shuttle/floor,/area/space)
"ae" = (/obj/structure/shuttle/engine/propulsion{dir = 8},/turf/simulated/floor/plating,/area/space)
"af" = (/obj/structure/shuttle/engine/heater{dir = 8},/obj/structure/window/reinforced{dir = 4},/obj/effect/floor_decal/industrial/warning{dir = 4},/turf/simulated/floor/plating,/area/space)
"ag" = (/obj/effect/floor_decal/industrial/warning{dir = 9},/obj/item/stack/cable_coil/random,/obj/effect/decal/cleanable/blood/oil,/turf/simulated/floor/tiled,/area/space)
"ah" = (/obj/effect/floor_decal/industrial/warning{dir = 1},/turf/simulated/floor/tiled,/area/space)
"ai" = (/obj/effect/floor_decal/industrial/warning{dir = 1},/obj/structure/table/steel,/obj/item/weapon/storage/toolbox/mechanical,/turf/simulated/floor/tiled,/area/space)
"aj" = (/obj/effect/floor_decal/industrial/warning{dir = 1},/obj/structure/table/steel,/obj/item/device/multitool,/turf/simulated/floor/tiled,/area/space)
"ak" = (/obj/effect/floor_decal/industrial/warning{dir = 1},/obj/structure/table/steel,/obj/item/weapon/storage/toolbox/electrical,/obj/item/stack/cable_coil/random,/turf/simulated/floor/tiled,/area/space)
"al" = (/obj/effect/floor_decal/industrial/warning{dir = 5},/obj/structure/table/steel,/obj/item/weapon/storage/toolbox/mechanical,/turf/simulated/floor/tiled,/area/space)
"am" = (/turf/simulated/floor/tiled/dark,/area/space)
"an" = (/obj/structure/table/standard,/obj/item/weapon/reagent_containers/glass/beaker,/turf/simulated/floor/tiled/dark,/area/space)
"ao" = (/turf/simulated/shuttle/floor,/area/space)
"ap" = (/obj/machinery/light{dir = 1},/turf/simulated/shuttle/floor,/area/space)
"aq" = (/obj/effect/floor_decal/industrial/warning{dir = 8},/turf/simulated/floor/tiled,/area/space)
"ar" = (/turf/simulated/floor/tiled,/area/space)
"as" = (/obj/machinery/door/airlock,/turf/simulated/shuttle/floor,/area/space)
"at" = (/obj/structure/table/standard,/obj/item/weapon/reagent_containers/glass/beaker/large,/obj/item/weapon/reagent_containers/dropper,/turf/simulated/floor/tiled/dark,/area/space)
"au" = (/obj/machinery/portable_atmospherics/canister/air/airlock,/turf/simulated/shuttle/floor,/area/space)
"av" = (/obj/effect/decal/cleanable/blood/oil,/turf/simulated/floor/tiled,/area/space)
"aw" = (/obj/effect/floor_decal/industrial/warning/corner,/turf/simulated/floor/tiled,/area/space)
"ax" = (/obj/effect/floor_decal/industrial/warning,/obj/item/stack/cable_coil/random,/turf/simulated/floor/tiled,/area/space)
"ay" = (/obj/effect/floor_decal/industrial/warning{dir = 6},/turf/simulated/floor/tiled,/area/space)
"az" = (/obj/item/weapon/stock_parts/matter_bin,/obj/item/weapon/stock_parts/matter_bin,/obj/structure/table/standard,/obj/item/weapon/stock_parts/scanning_module,/turf/simulated/floor/tiled/dark,/area/space)
"aA" = (/obj/item/weapon/stock_parts/manipulator,/obj/item/weapon/stock_parts/manipulator,/obj/structure/table/standard,/obj/item/weapon/stock_parts/capacitor,/obj/item/weapon/stock_parts/console_screen,/turf/simulated/floor/tiled/dark,/area/space)
"aB" = (/obj/machinery/r_n_d/destructive_analyzer,/turf/simulated/floor/tiled/dark,/area/space)
"aC" = (/obj/machinery/r_n_d/protolathe,/turf/simulated/floor/tiled/dark,/area/space)
"aD" = (/obj/effect/floor_decal/industrial/warning{dir = 10},/obj/item/weapon/wrench,/turf/simulated/floor/tiled,/area/space)
"aE" = (/obj/effect/floor_decal/industrial/warning,/turf/simulated/floor/tiled,/area/space)
"aF" = (/obj/effect/floor_decal/industrial/warning,/obj/machinery/portable_atmospherics/canister/air,/obj/machinery/light,/turf/simulated/floor/tiled,/area/space)
"aG" = (/obj/effect/floor_decal/industrial/warning,/obj/machinery/portable_atmospherics/canister/air,/turf/simulated/floor/tiled,/area/space)
"aH" = (/obj/effect/floor_decal/industrial/warning{dir = 6},/obj/machinery/portable_atmospherics/canister/air,/turf/simulated/floor/tiled,/area/space)
"aI" = (/obj/machinery/computer/rdconsole/core,/turf/simulated/floor/tiled/dark,/area/space)
"aJ" = (/obj/machinery/light,/turf/simulated/floor/tiled/dark,/area/space)
"aK" = (/obj/machinery/r_n_d/circuit_imprinter,/obj/item/weapon/reagent_containers/glass/beaker/sulphuric,/turf/simulated/floor/tiled/dark,/area/space)
"aL" = (/obj/machinery/suit_storage_unit/standard_unit,/obj/machinery/light{dir = 1},/turf/simulated/shuttle/floor,/area/space)
"aM" = (/obj/machinery/suit_storage_unit/standard_unit,/turf/simulated/shuttle/floor,/area/space)
"aN" = (/obj/machinery/computer/shuttle,/obj/machinery/light{dir = 1},/turf/simulated/shuttle/floor,/area/space)
"aO" = (/obj/machinery/computer/shuttle,/turf/simulated/shuttle/floor,/area/space)
"aP" = (/obj/structure/bed/chair/office/dark{dir = 1},/obj/effect/decal/remains/human,/turf/simulated/shuttle/floor,/area/space)
"aQ" = (/obj/structure/bed/chair/comfy/black{dir = 4},/obj/effect/decal/remains/human,/obj/item/weapon/cigbutt/cigarbutt,/turf/simulated/shuttle/floor,/area/space)
"aR" = (/obj/machinery/light,/turf/simulated/shuttle/floor,/area/space)
"aS" = (/obj/structure/bed/chair/office/dark,/obj/effect/decal/remains/human,/turf/simulated/shuttle/floor,/area/space)
"aT" = (/obj/machinery/sleeper{dir = 4},/obj/effect/floor_decal/industrial/warning{dir = 8},/obj/effect/decal/remains/human,/turf/simulated/shuttle/floor,/area/space)
"aU" = (/obj/machinery/sleeper,/obj/effect/decal/remains/human,/obj/machinery/light{dir = 1},/turf/simulated/shuttle/floor,/area/space)
"aV" = (/obj/machinery/sleeper,/obj/effect/decal/remains/human,/turf/simulated/shuttle/floor,/area/space)
"aW" = (/obj/item/weapon/material/shard{icon_state = "medium"},/turf/simulated/floor/tiled/dark,/area/space)
"aX" = (/obj/machinery/light{dir = 1},/turf/simulated/floor/tiled/dark,/area/space)
"aY" = (/turf/simulated/floor/plating,/area/space)
"aZ" = (/obj/item/stack/tile/floor,/turf/simulated/floor/plating,/area/space)
"ba" = (/obj/effect/floor_decal/asteroid,/turf/simulated/floor/plating,/area/space)
"bb" = (/obj/item/weapon/material/shard{icon_state = "small"},/obj/item/stack/rods,/obj/machinery/light{tag = "icon-tube1 (NORTH)"; icon_state = "tube1"; dir = 1},/turf/simulated/floor/plating,/area/space)
"bc" = (/obj/machinery/suit_storage_unit/standard_unit,/obj/machinery/light,/turf/simulated/shuttle/floor,/area/space)
"bd" = (/obj/machinery/computer/shuttle,/obj/machinery/light,/turf/simulated/shuttle/floor,/area/space)
"be" = (/obj/structure/table/standard,/turf/simulated/shuttle/floor,/area/space)
"bf" = (/obj/item/weapon/material/shard,/obj/item/stack/rods,/turf/simulated/floor/tiled/dark,/area/space)
"bg" = (/obj/effect/floor_decal/asteroid,/turf/simulated/floor/tiled/dark,/area/space)
"bh" = (/turf/simulated/mineral/random,/area/space)
"bi" = (/obj/item/weapon/material/shard,/turf/simulated/shuttle/floor,/area/space)
"bj" = (/obj/item/weapon/material/shard{icon_state = "small"},/turf/simulated/shuttle/floor,/area/space)
"bk" = (/obj/machinery/sleeper{dir = 1},/turf/simulated/shuttle/floor,/area/space)
"bl" = (/obj/item/weapon/material/shard{icon_state = "small"},/turf/simulated/floor/plating,/area/space)
"bm" = (/obj/item/weapon/material/shard{icon_state = "medium"},/obj/machinery/light,/turf/simulated/shuttle/floor,/area/space)

(1,1,1) = {"
aaaaaaaaaaaaaaaaaaaaaaaaaaaaaaaaaaaaaaaaaaaaaaaaaaaaaaaaaaaaaaaa
aaaaaaaaaaaaaaaaaaaaaaaaaaaaaaaaaaaaaaaaaaaaaaaaaaaaaaaaaaaaaaaa
aaaaaaaaaaaaaaaaaaaaaaaaaaaaaaaaaaaaaaaaaaaaaaaaaaaaaaaaaaaaaaaa
aaaaaaaaaaaaaaaaaaaaaaaaaaaaaaaaaaaaaaaaaaaaaaaaaaaaaaaaaaaaaaaa
aaaaaaaaaaaaaaaaaaaaaaaaaaaaaaaaaaaaaaaaaaaaaaaaaaaaaaaaaaaaaaaa
aaaaaaaaaaaaaaaaaaaaaaaaaaaaaaaaaaaaaaaaaaaaaaaaaaaaaaaaaaaaaaaa
aaaaaaaaaaaaaaaaaaaaaaaaaaaaaaaaaaaaaaaaaaaaaaaaaaaaaaaaaaaaaaaa
aaaaaaaaaaaaaaaaaaaaaaaaaaaaaaaaaaaaaaaaaaaaaaaaaaaaaaaaaaaaaaaa
aaaaaaaaaaaaaaaaaaaaaaaaaaaaaaaaaaaaaaaaaaaaaaaaaaaaaaaaaaaaaaaa
aaaaaaaaaaaaaaaaaaaaaaaaaaaaaaaaaaaaaaaaaaaaaaaaaaaaaaaaaaaaaaaa
abababacacacabababababababababacacacababababacadacababaaaaaaaaaa
aeafagahahahaiajakalabamamamamamamamamamanabaoaoaoapabaaaaaaaaaa
aeafaqarararararararasamamamamamamamamamatabaoaoaoauababaaaaaaaa
aeafaqarararavawaxayabazaAaBamaCamamamamababacadacabababacacacaa
aeafaDaEaraFaGaHabababababaIaJaKamamamaJabaLaMaoaMaLabaNaOaOacac
ababababasababababaoapaoababababasababababaoaoaoaoaoabaoaPaoaOac
abaoaoaoaoaoaoaoaoaoaoaoaoaoaoaoaoaoaoaoaoaoaoaoaoaoasaoaoaoaQac
ababababasababababaoaRaoababababasababababaoaoaoaoaoabaoaSaoaOac
aeafaTaoaoaUaVaVabababababaWaXaYaYaZbabbabbcaMaoaMbcabbdaOaOacac
aeafaTaoaoaoaoaobebeabbfbgaYbaaYbhbhbhbhababacadacabababacacacaa
aeafaTaoaoaoaoaoaoaoasaWaYaYbhbhbhbhbhbhbhaYbabibjaoababaaaaaaaa
aeafaTaobebebkbkbkbkabblaZbhbhbhbhbhbhbhbhbhblaYaobmabaaaaaaaaaa
abababacacacabababababababbhbhbhbhbhbhbhbhbhbhaaacababaaaaaaaaaa
aaaaaaaaaaaaaaaaaaaaaaaaaabhbhbhbhbhbhbhbhbhbhaaaaaaaaaaaaaaaaaa
aaaaaaaaaaaaaaaaaaaaaaaaaabhbhbhbhbhbhbhbhbhbhaaaaaaaaaaaaaaaaaa
aaaaaaaaaaaaaaaaaaaaaaaaaaaabhbhbhbhbhbhbhbhaaaaaaaaaaaaaaaaaaaa
aaaaaaaaaaaaaaaaaaaaaaaaaaaaaabhbhbhbhbhbhbhaaaaaaaaaaaaaaaaaaaa
aaaaaaaaaaaaaaaaaaaaaaaaaaaaaaaaaabhbhbhbhaaaaaaaaaaaaaaaaaaaaaa
aaaaaaaaaaaaaaaaaaaaaaaaaaaaaaaaaaaaaaaaaaaaaaaaaaaaaaaaaaaaaaaa
aaaaaaaaaaaaaaaaaaaaaaaaaaaaaaaaaaaaaaaaaaaaaaaaaaaaaaaaaaaaaaaa
aaaaaaaaaaaaaaaaaaaaaaaaaaaaaaaaaaaaaaaaaaaaaaaaaaaaaaaaaaaaaaaa
aaaaaaaaaaaaaaaaaaaaaaaaaaaaaaaaaaaaaaaaaaaaaaaaaaaaaaaaaaaaaaaa
"}
